###############################################################################
#######.............###################..........................####....######
#####................###############......................................#####
###....................##########............##############.##..............###
####.....................####...........###############...####............#####
#######...................########.....#....#######.........######.......######
##########...................####.....#......#####............####.......###..#
########.................................#...#####.............#######..###...#
####....................#....................#####...........########....##...#
###....................................#.....####.....#.......######.....#....#
####.......................##.............#..###..............#####...........#
###........................##..............####................######.....#...#
####..........#.....................#.#....######................###..........#
###...........##.............................#####.................###....#...#
###...........###.............................####........#...................#
###..........#####.......#....................................................#
#####.........####..........................#.......................###.....#.#
###..........####....................#.............................####.......#
####..........####........................###.....................####........#
#####.........###.........#.....###############..........#.........####.......#
####.........#####................################.................#####...#..#
####........######..............##################................#####.......#
####.........##########..........###################..............######......#
######...............................##########....................######.....#
#######................................######......................####.......#
#####............#........................................####......##.......##
###......................#......#....................##..###.................##
###....................###.........#.........##...............##........#######
####.....###..#######.........##.........##......##......###................###
###############################################################################
